+-+-+-+-+-+-+-+-+-+-+-+-+-+-+-+-+-+-+-+-+-+-+-+-+-+-+-+
$$$$$$$$$$$$|   |       |$$$$$|$$$$$$$|       |   |   |
+-+-+-+-+-+$+-+ + +-+-+ +$+-+$+$+-+ +$+ +-+-+ + + +-+ +
|$$$$$|    $|   | |     |$|$$$|$| | |$|   |     |     |
+$+ +$+-+-+$+ +-+ + +-+-+$+$+-+$+ + +$+-+-+ +-+-+ + +-+
|$| |$|$$$$$|   | | |   |$|$|$$$|   |$$$$$  |     |   |
+$+-+$+$+-+-+-+ + + +-+ +$+$+$+-+-+-+-+-+$+-+ +-+-+ +-+
|$|$$$|$$$|  $$$| |   | |$|$|$|  $$$$$$$$$|   |   |   |
+$+$+-+ +$+-+$+$+ +-+ + +$+$+$+ +$+-+-+-+-+ +-+-+ +-+-+
|$|$$$| |$|$$$|$| |   | |$|$$$| |$|   |           |   |
+$+-+$+-+$+$+-+$+-+ +-+ +$+-+-+ +$+ +-+ +-+ +-+-+-+ +-+
|$$$|$$$$$|$$$|$$$$$$$$$|$|     |$|     | | |   | |   |
+-+$+-+-+-+-+$+-+-+ +-+$+$+ +-+-+$+-+-+-+ + + + + + +-+
|  $$$$$$$$$|$|   |   |$$$|   |$$$|$$$|   |   | | |   |
+ +-+-+ +-+$+$+ + +-+ +-+-+-+ +$+-+$+$+ +-+-+ + + +-+ +
| | |     |$|$  | |   |       |$|$$$|$|       |   |   |
+ + + +-+ +$+$+-+ + +-+-+-+-+-+$+$+ +$+-+-+-+-+-+-+-+-+
| | | |   |$|$| |       |     |$|$| |$$$$$$$|     |   |
+ + + + +-+$+$+ +-+ +-+ + +-+ +$+$+-+-+-+-+$+ +-+ + +-+
|   | |   |$$$|   | |   |   | |$$$|     |  $$$$$| |   |
+-+-+ +-+ +-+-+-+ +-+ +-+-+-+ +-+-+ +-+ + +-+ +$+-+-+ +
|   |   | |     |     |     | |   |   | |   | |$$$|   |
+ + +-+-+ + +-+ +-+ +-+-+-+ + +-+ +-+-+ +-+ + +-+$+-+-+
|         |   |     |   |     |     |   |     |  $$$$$$
+-+-+-+-+-+-+-+-+-+-+-+-+-+-+-+-+-+-+-+-+-+-+-+-+-+-+-+
